"publisher","Cornell","Duke","Michigan","Minnesota","Virginia Tech","Washington U","Total"
"ENCODE Data Coordination Center",12,1006,138566,0,0,0,139584
"Faculty Opinions Ltd",674,2574,2516,1682,64,502,8012
"Dryad",656,469,496,528,158,149,2456
"figshare",597,238,373,231,294,543,2276
"Institutional Repository",157,224,537,774,426,95,2213
"Zenodo",957,276,385,323,159,66,2166
"ICPSR",92,125,1287,99,6,49,1658
"Harvard Dataverse",251,289,308,123,28,0,999
"Taylor & Francis",105,30,75,52,43,155,460
"Neotoma Paleoecological Database",0,4,0,210,0,0,214
"VTTI",0,0,1,2,113,0,116
"MassIVE",30,34,12,11,1,12,100
"SciELO journals",22,12,12,6,10,12,74
"Authorea, Inc.",12,10,16,13,0,14,65
"Borealis",11,15,9,20,5,0,60
"OBIS-SEAMAP",0,49,0,0,0,0,49
"Future Science Group",4,2,0,4,22,12,44
"SAGE Journals",2,2,12,2,0,18,36
"KNB Data Repository",19,10,2,2,1,0,34
"IEEE DataPort",1,0,15,10,1,4,31
"Biological and Chemical Oceanography Data Management Office",6,13,10,0,0,0,29
"NASA Space Physics Data Facility",0,0,0,29,0,0,29
"Databrary",15,13,0,0,0,0,28
"Virginia Tech Transportation Institute",0,0,0,0,27,0,27
"UCAR/NCAR - Earth Observing Laboratory",4,0,21,0,0,0,25
"Biological and Chemical Oceanography Data Management Office (BCO-DMO)",5,2,7,10,0,0,24
"The Royal Society",10,0,6,0,0,4,20
"CSIRO",4,1,0,14,0,0,19
"DOE Joint Genome Institute",4,6,4,3,0,0,17
"UNC Dataverse",1,9,4,2,1,0,17
"NSF Arctic Data Center",0,15,0,1,0,0,16
"ImmPort",0,9,3,3,0,1,16
"Washington University in St. Louis",0,0,0,0,0,16,16
"DataverseNL",4,2,3,6,0,0,15
"Optica Publishing Group",0,2,11,0,0,2,15
"CyVerse Data Commons",12,0,0,2,0,0,14
"Geochemistry, Geophysics, Geosystems",1,0,0,12,0,0,13
"QDR Main Collection",4,6,2,0,0,0,12
"G-Node",0,4,2,6,0,0,12
"Cornell Institute for Social and Economic Research",11,0,0,0,0,0,11
"Root",0,0,11,0,0,0,11
"SBGrid Data Bank",8,0,1,0,0,1,10
"NOAA Global Monitoring Laboratory",0,0,7,3,0,0,10
"AmeriFlux; University of Minnesota; USDA-ARS",0,0,0,10,0,0,10
"International Federation of Digital Seismograph Networks",7,0,1,0,1,0,9
"Stanford Digital Repository",0,0,9,0,0,0,9
"Arctic Data Center",0,0,7,2,0,0,9
"CaltechDATA",4,0,4,0,0,0,8
"USDA Forest Service",2,0,2,4,0,0,8
"Environmental System Science Data Infrastructure for a Virtual Ecosystem; Defense Coastal/Estuarine Research Program (DCERP)",0,4,1,0,3,0,8
"World Values Survey Association",0,0,8,0,0,0,8
"PARADIM, an NSF Materials Innovation Platform",6,0,0,0,0,0,6
"Johns Hopkins University Data Archive",0,4,2,0,0,0,6
"GSA Journals",0,2,0,2,2,0,6
"DataverseNO",0,0,6,0,0,0,6
"Portail Data INRAE",0,0,6,0,0,0,6
"Recherche Data Gouv",0,0,0,6,0,0,6
"Cornell University Museum of Vertebrates",5,0,0,0,0,0,5
"DR-NTU (Data)",5,0,0,0,0,0,5
"University of St Andrews",3,0,0,1,0,1,5
"Science Data Bank",1,0,1,3,0,0,5
"CSES - Comparative Study of Electoral Systems",0,0,3,2,0,0,5
"Cornell Center for Social Sciences",4,0,0,0,0,0,4
"Earth System Grid Federation",4,0,0,0,0,0,4
"TRR 170-DB",4,0,0,0,0,0,4
"NERC Environmental Information Data Centre",1,0,0,3,0,0,4
"Environmental System Science Data Infrastructure for a Virtual Ecosystem; Free Air CO2 Enrichment Model Data Synthesis (FACE-MDS)",0,2,2,0,0,0,4
"SCAR - Microbial Antarctic Resource System",0,2,1,0,0,1,4
"EnviDat",0,1,0,3,0,0,4
"Open Data Commons for Spinal Cord Injury (ODC-SCI)",0,1,0,3,0,0,4
"DANS/KNAW",0,0,4,0,0,0,4
"Dartmouth Dataverse",0,0,4,0,0,0,4
"ACSS Dataverse",0,0,2,2,0,0,4
"GESIS Data Archive",0,0,2,2,0,0,4
"Journal of Geophysical Research: Solid Earth",0,0,2,2,0,0,4
"Qualitative Data Repository",0,0,2,2,0,0,4
"Digital Rocks Portal",0,0,1,0,3,0,4
"GFZ Data Services",0,0,1,3,0,0,4
"Environmental System Science Data Infrastructure for a Virtual Ecosystem; Trace Metal Dynamics and Limitations on Biogeochemical Cycling in Wetland Soils and Hyporheic Zones",0,0,0,0,0,4,4
"A Rocha Kenya",2,0,1,0,0,0,3
"Edmond",1,0,2,0,0,0,3
"AmeriFlux; University of Toledo / Michigan State University",0,0,3,0,0,0,3
"Data Archiving and Networked Services (DANS)",0,0,3,0,0,0,3
"FluxNet; University of Toledo / Michigan State University",0,0,3,0,0,0,3
"Root Dataverse",0,0,3,0,0,0,3
"Social Sciences and Digital Humanities Archive – SODHA",0,0,3,0,0,0,3
"Penn State Data Commons",0,0,1,2,0,0,3
"National Renewable Energy Laboratory - Data (NREL-DATA), Golden, CO (United States); National Renewable Energy Laboratory (NREL), Golden, CO (United States)",0,0,0,3,0,0,3
"ASU Library Research Data Repository",0,0,0,0,3,0,3
"PLOS One",2,0,0,0,0,0,2
"ADA Dataverse",0,0,2,0,0,0,2
"The University of Western Australia",0,0,2,0,0,0,2
"University of Western Australia",0,0,2,0,0,0,2
"DataFirst",0,0,1,0,0,1,2
"NOAA Earth System Research Laboratory, Global Monitoring Division",0,0,1,1,0,0,2
"DaRUS",0,0,0,2,0,0,2
"Environmental System Science Data Infrastructure for a Virtual Ecosystem; AmeriFlux Management Project",0,0,0,2,0,0,2
"International Potato Center",0,0,0,0,2,0,2
"Microbiology Society",0,0,0,0,2,0,2
"American College of Radiology",0,0,0,0,0,2,2
"American Journal of Agricultural Economics",1,0,0,0,0,0,1
"DataSuds",1,0,0,0,0,0,1
"Journal of Human Resources",1,0,0,0,0,0,1
"Mohonk Preserve",1,0,0,0,0,0,1
"MultiSector Dynamics - Living, Intuitive, Value-adding, Environment",1,0,0,0,0,0,1
"National Institute of Standards and Technology",1,0,0,0,0,0,1
"NOAA National Centers for Environmental Information",1,0,0,0,0,0,1
"SimTK",1,0,0,0,0,0,1
"Universität Konstanz",1,0,0,0,0,0,1
"University of Massachusetts Amherst",1,0,0,0,0,0,1
"Center for International Forestry Research (CIFOR)",0,1,0,0,0,0,1
"Environmental System Science Data Infrastructure for a Virtual Ecosystem; Net Methylation Potential of Mercury Sulfides for Different Groups of the Methylating Microbial Community",0,1,0,0,0,0,1
"Jülich DATA",0,1,0,0,0,0,1
"National Data Archive on Child Abuse and Neglect (NDACAN)",0,1,0,0,0,0,1
"NILU - Norsk Institutt for Luftforskning",0,1,0,0,0,0,1
"Oxford Brookes University",0,1,0,0,0,0,1
"Pfizer",0,1,0,0,0,0,1
"SEANOE",0,1,0,0,0,0,1
"Southwestern Pacific Ocean Biogeographic Information System (OBIS) Node",0,1,0,0,0,0,1
"U.S. Geological Survey",0,1,0,0,0,0,1
"UiT Open Research Data Dataverse",0,1,0,0,0,0,1
"World Data Center for Climate (WDCC) at DKRZ",0,1,0,0,0,0,1
"Center for Macroecology, Evolution and Climate, University of Copenhagen",0,0,1,0,0,0,1
"EarthSpace",0,0,1,0,0,0,1
"Institute for Research on Innovation and Science (IRIS)",0,0,1,0,0,0,1
"International Soil Carbon Network (ISCN);",0,0,1,0,0,0,1
"Invasive Species Specialist Group ISSG",0,0,1,0,0,0,1
"NASA Planetary Data System",0,0,1,0,0,0,1
"National Data Archive on Child Abuse and Neglect",0,0,1,0,0,0,1
"Natural History Museum",0,0,1,0,0,0,1
"physionet.org",0,0,1,0,0,0,1
"Publisher",0,0,1,0,0,0,1
"UCLA Dataverse",0,0,1,0,0,0,1
"UNAVCO, Inc",0,0,1,0,0,0,1
"University of Bath",0,0,1,0,0,0,1
"University of Leeds",0,0,1,0,0,0,1
"University of Miami Libraries",0,0,1,0,0,0,1
"University of Michigan Museum of Paleontology",0,0,1,0,0,0,1
"Utah State University",0,0,1,0,0,0,1
"Κατάλογος Δεδομένων SoDaNet",0,0,1,0,0,0,1
"AmeriFlux; University of Minnesota; USDA- Forest Service",0,0,0,1,0,0,1
"AmeriFlux; University of Minnesota; USDA-Forest Service",0,0,0,1,0,0,1
"AmeriFlux; University of Minnesota; USDA-Forest Service-International Programs",0,0,0,1,0,0,1
"Environmental System Science Data Infrastructure for a Virtual Ecosystem; AmeriFlux",0,0,0,1,0,0,1
"Environmental System Science Data Infrastructure for a Virtual Ecosystem; AmeriFlux Network Management Project",0,0,0,1,0,0,1
"EOL Data Support. UCAR/NCAR - Earth Observing Laboratory",0,0,0,1,0,0,1
"Forest Service Research Data Archive",0,0,0,1,0,0,1
"Geology",0,0,0,1,0,0,1
"Global Carbon Project",0,0,0,1,0,0,1
"Lawrence Berkeley National Laboratory (LBNL), Berkeley, CA (United States)",0,0,0,1,0,0,1
"LibGuides dataset: Subject guides at academic libraries",0,0,0,1,0,0,1
"Max Planck Institute for Biogeochemistry, Jena",0,0,0,1,0,0,1
"Proceedings of the National Academy of Sciences",0,0,0,1,0,0,1
"Tectonics",0,0,0,1,0,0,1
"University of Iowa",0,0,0,1,0,0,1
"University of Oxford",0,0,0,1,0,0,1
"Digital Rocks Portal University of Texas at Austin",0,0,0,0,1,0,1
"Environmental System Science Data Infrastructure for a Virtual Ecosystem",0,0,0,0,1,0,1
"Northwest Knowledge Network",0,0,0,0,1,0,1
"Univeristy of Leeds",0,0,0,0,1,0,1
"Virginia Polytechnic Inst. and State Univ. (Virginia Tech), Blacksburg, VA (United States)",0,0,0,0,1,0,1
"Digital Commons @ Becker, Data and Supporting Files",0,0,0,0,0,1,1
"Digital Commons@Becker, Data and Supporting files",0,0,0,0,0,1,1
"Digital Commons@Becker, Data and Supporting Files",0,0,0,0,0,1,1
"Environmental System Science Data Infrastructure for a Virtual Ecosystem; Trace Metal Dynamics and Limitations on Biogeochemical Cycling in Wetland Soils and Hyporheic Zones, PI Jeffrey G. Catalano",0,0,0,0,0,1,1
"ForestPlots.net",0,0,0,0,0,1,1
"Open Data Repository",0,0,0,0,0,1,1
"Woods Hole Oceanographic Institution",0,0,0,0,0,1,1
